5 4 3 4 3 3
3 4 3 3 3 1
3 3 3 3 3 0
3 3 3 3 2 0
3 4 0 1 1 0
2 0 0 0 0 1