3 3 3 3 3 1
3 3 3 4 3 1
3 3 3 3 2 1
3 3 3 2 2 0
3 4 3 3 2 0
2 1 3 2 0 1